               
 ............. 
 .          #. 
 . ......... . 
 . .#     #. . 
 . . ..... . . 
 . . .#  . . . 
 . . ..0 . . . 
 . .#   #. . . 
 . ....... . . 
 .        #. . 
 ........... . 
            #. 
       ....... 
       1#      
